111111111111111111111
10CC00000000P000000E1
100000000000010000111
111000000000000000111
1C0000000000010000111
111111111111111111111