111111111111111111111
1P0000000CCCC000000E1
100000000000000000111
111111111111111111111