11111
1P001
1EC01
11111
11111
11111
