11111111111111111111111111
1P0000100C0000000000000001
111000000000000000000C0001
10C00000000000000010111111
1C1100000000000000100000E1
11111111111111111111111111